0 0 0 0 0 0 0 0 0 0 0 0 0 0 0 0
0 0 0 0 0 0 0 0 0 0 0 0 0 0 0 0
0 0 0 0 0 0 0 0 0 0 0 0 0 0 0 0
0 0 0 0 0 0 0 0 0 0 0 0 0 0 0 0
0 0 0 0 0 0 0 0 0 0 0 0 0 0 0 0
0 0 0 0 0 0 0 0 0 33 8 8 49 0 0 0
0 0 0 0 0 0 0 0 33 8 8 8 8 8 49 0
0 0 0 0 0 0 0 0 8 8 8 0 0 8 8 0
0 0 0 0 0 0 0 0 8 8 8 0 0 0 8 0
0 0 0 0 0 0 0 0 8 8 8 0 0 8 8 0
0 0 0 0 0 0 0 0 8 8 8 0 0 8 8 0
0 0 0 0 0 0 0 0 8 8 1 0 0 17 8 0
0 0 0 0 0 0 0 0 8 8 0 0 0 0 0 0
0 0 0 0 0 0 0 0 8 1 0 0 0 0 0 0
0 0 0 0 0 0 0 0 0 0 0 0 0 0 0 0
0 0 0 0 0 0 0 0 0 0 0 0 0 0 0 0
